      BOBOOOOOOOOOB 
   BOOBGo         BB
   o G  o          o
BOOB    o          o
o G BOOOBOOOOOB    B
oG   :      *    H D
o G BOOOBOOOOOB    B
BOOB    o          o
   o G  o          o
   BOOBGo         BB
      BOBOOOOOOOOOB 
                    
